# Sample 1
5 8
########
#.A#...#
#.##.#B#
#......#
########



# Sample 2
10 10
##.A######
#.##.##.##
#####..###
.#########
.########.
###.###.##
#########.
######.#.#
###..###.#
###.B#####